25 26 26 26 26 26 26 26 26 26 26 26 26 26 27
32 00 00 00 00 00 00 00 00 00 00 00 00 00 28
32 00 16 05 01 05 16 16 16 05 01 05 16 00 28
32 00 00 00 02 00 00 00 00 00 02 00 00 00 28
32 00 16 00 02 03 03 03 03 03 02 00 16 00 28
32 00 00 00 02 00 00 00 00 00 02 00 00 00 28
32 00 16 00 02 03 03 03 03 03 02 00 16 00 28
32 00 00 00 02 00 00 00 00 00 02 00 00 00 28
32 00 16 00 02 03 03 03 03 03 02 00 16 00 28
32 00 00 00 02 00 00 00 00 00 02 00 00 00 28
32 00 16 00 02 03 03 03 03 03 02 00 16 00 28
32 00 00 00 02 00 00 00 00 00 02 00 00 00 28
32 00 16 05 01 05 16 16 16 05 01 05 16 00 28
32 00 00 00 00 00 00 00 00 00 00 00 00 00 28
31 30 30 30 30 30 30 30 30 30 30 30 30 30 29