12 7 7 7 7 7 7 7 7 7 7 7 7 7 10
14 0 0 0 0 0 0 0 0 0 0 0 0 0 15
14 0 4 5 5 5 5 5 5 5 5 5 2 0 15
14 0 4 0 0 0 0 0 0 0 0 0 2 0 15
14 0 4 0 1 0 0 0 0 0 1 0 2 0 15
14 0 4 0 1 0 3 3 3 0 1 0 2 0 15
14 0 4 0 1 0 3 0 3 0 1 0 2 0 15
14 0 4 0 1 0 3 3 3 0 1 0 2 0 15
14 0 4 0 1 0 0 0 0 0 1 0 2 0 15
14 0 4 0 0 0 0 0 0 0 0 0 2 0 15
14 0 4 5 5 5 5 5 5 5 5 5 2 0 15
14 0 0 0 0 0 0 0 0 0 0 0 0 0 15
13 9 9 9 9 9 9 9 9 9 9 9 9 9 11