25 26 26 26 26 26 26 26 26 26 26 26 26 26 27
32 00 00 00 00 00 00 00 00 00 00 00 00 00 28
32 08 17 08 17 08 17 08 17 08 17 08 17 08 28
32 00 00 00 00 00 00 00 00 00 00 00 00 00 28
32 08 17 08 17 08 17 08 17 08 17 08 17 08 28
32 00 00 00 00 00 00 00 00 00 00 00 00 00 28
32 08 17 08 17 08 17 08 17 08 17 08 17 08 28
32 00 00 00 00 00 00 00 00 00 00 00 00 00 28
32 08 17 08 17 08 17 08 17 08 17 08 17 08 28
32 00 00 00 00 00 00 00 00 00 00 00 00 00 28
32 08 17 08 17 08 17 08 17 08 17 08 17 08 28
32 00 00 00 00 00 00 00 00 00 00 00 00 00 28
32 08 17 08 17 08 17 08 17 08 17 08 17 08 28
32 00 00 00 00 00 00 00 00 00 00 00 00 00 28
31 30 30 30 30 30 30 30 30 30 30 30 30 30 29