25 26 26 26 26 26 26 26 26 26 26 26 26 26 27
32 00 00 08 00 00 00 00 00 00 00 08 00 00 28
32 00 17 08 00 00 08 08 08 00 00 08 17 00 28
32 08 08 08 00 00 00 08 00 00 00 08 08 08 28
32 00 00 00 00 00 08 08 08 00 00 00 00 00 28
32 00 00 00 00 00 00 00 00 00 00 00 00 00 28
32 00 08 00 08 00 00 08 00 00 08 00 08 00 28
32 00 08 08 08 00 08 08 08 00 08 08 08 00 28
32 00 08 00 08 00 00 08 00 00 08 00 08 00 28
32 00 00 00 00 00 00 00 00 00 00 00 00 00 28
32 00 00 00 00 00 08 08 08 00 00 00 00 00 28
32 08 08 08 00 00 00 08 00 00 00 08 08 08 28
32 00 17 08 00 00 08 08 08 00 00 08 17 00 28
32 00 00 08 00 00 00 00 00 00 00 08 00 00 28
31 30 30 30 30 30 30 30 30 30 30 30 30 30 29